111111111111111111
1P00C00000000000E1
101000000010000001
111111111111111111
