111111111111111111
1P00000000000000E1
1010000C0100000011
100100001010000101
1C0010010001001001
100001100000110001
1CCCCCCCCCCCCCCCC1
111111111111111111
