111111111111111111111111111
10000000011000000100E000001
1P1111101011111011011C00001
100001C0100000100C001000001
101101111011101011101C10001
101100000C0000100C001110001
101101111111101011101000001
10110000000000100C001001111
101111101011111011101000001
1000000010C000000001C000001
101111101011111011111100001
100000001000000C00000C00001
101111111011111011111100001
100001000000C00000010000001
10C00100000000000C010000001
111111111111111111111111111
