111111111111111111111111111
10000000Z11ZZZZZZ100E000001
1P1111101011111011011C00001
100001C0100000100C0010Z0001
1011011110111010111Z1C10001
101100000C0000100C001110001
101101111111101Z11101000001
10110000000000100C001001111
101111101011111011101Z00001
1000000010C000000001C000001
1Z1111101011111011111100001
100000001Z00000C00000C00001
101111111011111011111100001
1000Z1Z00000C00000Z10000001
10C001Z0000000000CZ10000001
111111111111111111111111111
