1111
1P01
1C01
10Z1
1E01
1111
