111111111111111111
1P00000000000000E1
101ZZZZCZ1ZZZZZZ11
1001000Z1010000101
1C0010010001001001
10ZZZ11ZZZZZ11ZZZ1
1CCCCCCCCCCCCCCCC1
111111111111111111
